movie, film - 映画
movie theatre, cinema - 映画館
station - 駅
english - 英語
pencil - 鉛筆
great number of people - 大勢
sweets, candy, confections - お菓子
to put, to place - 置く
wife - 奥さん
alcohol, sake (rice wine) - お酒
plate - お皿
uncle, middle aged man - 叔父・伯父さん
to teach - 教える
to push, to press - 押す
late, slow - 遅い
aunt - 叔母さん
bath - お風呂
boxed lunch - お弁当
to remember, to memorize - 覚える
heavy - 重い
to swim - 泳ぐ
to alight, to get off - 降りる
to finish - 終わる
music - 音楽
stairs - 階段
to return something - 返す
to go home, to return - 帰る
face (person) - 顔
umbrella - 傘
to lend - 貸す
cold, illness - 風邪
family - 家族
katakana - 片仮名
school - 学校
home, household - 家庭
