sugar- 砂糖
cold - 寒い
walk - 散歩
salt - 塩
work, occupation - 仕事
dictionary - 辞書
quiet, peaceful - 静か
question - 質問
bicycle - 自転車
automobile - 自動車
dictionary (old) - 字引
to close - 閉める
to tie, to fasten - 締める
photograph - 写真
class, lesson - 授業
homework - 宿題
cafeteria - 食堂
newspaper - 新聞
to smoke, breathe in - 吸う
cool - 涼しい
to reside, to live in - 住む
to sit - 座る
height, stature - 背
pupil - 生徒
soap - 石鹸
business suit - 背広
narrow -狭い
washing, laundry - 洗濯
cleaning - 掃除
embassy - 大使館
kitche - 台所
building - 建物
to request, to ask - 頼む
egg - 卵
near, close by - 近い
to differ (from) - 違う
subway - 地下鉄
map - 地図
to get tired - 疲れる
to arrive at, to reach - 着く
desk - 机
to serve, to work (for) - 勤める
cold (to touch) - 冷たい
strong - 強い
letter - 手紙
animal - 動物
far, distant - 遠い
watch, clock - 時計
library - 図書館
next to - 隣
