sugar- 砂糖
walk - 散歩
salt - 塩
dictionary - 辞書
quiet, peaceful - 静か
question - 質問
bicycle - 自転車
to close - 閉める
to tie, to fasten - 締める
photograph - 写真
class, lesson - 授業
homework - 宿題
cafeteria - 食堂
to smoke, breathe in - 吸う
cool - 涼しい
to reside, to live in - 住む
to sit - 座る
pupil - 生徒
soap - 石鹸
business suit - 背広
narrow -狭い
cleaning - 掃除
building - 建物
to request, to ask - 頼む
to differ (from) - 違う
subway - 地下鉄
to get tired - 疲れる
to serve, to work (for) - 勤める
cold (to touch) - 冷たい
strong - 強い
next to - 隣
